BRICKS_PER_ROW 10
ROWS_OF_BRICKS 6
0 0 0 0 0 0 0 0 0 0 
0 0 0 0 0 0 0 0 0 0 
0 0 2 1 2 2 3 1 0 0 
0 0 3 1 1 2 1 3 0 0 
0 0 2 3 1 2 2 2 0 0 
0 0 0 0 0 0 0 0 0 0 
