BRICKS_PER_ROW 10
ROWS_OF_BRICKS 6
0 0 0 0 0 0 0 0 0 0 
0 0 0 0 0 0 0 0 0 0 
0 0 1 1 2 1 2 2 0 0 
0 0 1 2 2 2 1 1 0 0 
0 0 1 2 2 1 2 2 0 0 
0 0 0 0 0 0 0 0 0 0 
