BRICKS_PER_ROW 10
ROWS_OF_BRICKS 6
0 0 0 0 0 0 0 0 0 0 
0 0 0 0 0 0 0 0 0 0 
0 0 1 3 1 2 1 1 0 0 
0 0 3 3 1 1 3 1 0 0 
0 0 3 2 2 1 2 3 0 0 
0 0 0 0 0 0 0 0 0 0 
