BRICKS_PER_ROW 10
ROWS_OF_BRICKS 6
0 0 0 0 0 0 0 0 0 0 
0 0 0 0 0 0 0 0 0 0 
0 0 4 4 3 3 3 1 0 0 
0 0 1 3 4 2 4 4 0 0 
0 0 1 3 2 3 3 2 0 0 
0 0 0 0 0 0 0 0 0 0 
