BRICKS_PER_ROW 10
ROWS_OF_BRICKS 6
0 0 0 0 0 0 0 0 0 0 
0 0 0 0 0 0 0 0 0 0 
0 0 3 1 2 4 1 1 0 0 
0 0 1 3 4 4 3 1 0 0 
0 0 4 2 2 2 4 3 0 0 
0 0 0 0 0 0 0 0 0 0 
