BRICKS_PER_ROW 10
ROWS_OF_BRICKS 6
0 0 0 0 0 0 0 0 0 0 
0 0 0 0 0 0 0 0 0 0 
0 0 1 2 3 2 1 5 0 0 
0 0 4 4 2 4 5 1 0 0 
0 0 4 5 4 5 4 2 0 0 
0 0 0 0 0 0 0 0 0 0 
