BRICKS_PER_ROW 10
ROWS_OF_BRICKS 6
0 0 0 0 0 0 0 0 0 0 
0 0 0 0 0 0 0 0 0 0 
0 0 5 3 2 1 4 3 0 0 
0 0 3 4 4 5 1 5 0 0 
0 0 5 4 4 3 4 4 0 0 
0 0 0 0 0 0 0 0 0 0 
